"a" = (/turf/space,/area/space)
"b" = (/obj/effect/landmark/map_data{height = 2},/turf/space,/area/space)
"c" = (/turf/simulated/wall,/area/space)
"d" = (/obj/effect/floor_decal/corner/blue/diagonal,/obj/structure/iv_drip,/obj/item/reagent_containers/ivbag/blood/OMinus,/obj/item/reagent_containers/ivbag/blood/OMinus,/obj/item/reagent_containers/ivbag/blood/OMinus,/turf/simulated/floor/tiled/white,/area/space)
"e" = (/obj/effect/floor_decal/corner/blue/diagonal,/obj/machinery/optable,/obj/machinery/oxygen_pump/anesthetic{pixel_y = 32},/turf/simulated/floor/tiled/white,/area/space)
"f" = (/obj/effect/floor_decal/corner/blue/diagonal,/obj/machinery/computer/operating,/turf/simulated/floor/tiled/white,/area/space)
"g" = (/obj/machinery/light{dir = 1},/obj/effect/floor_decal/corner/blue/diagonal,/obj/structure/table/glass,/obj/item/storage/box/syringes,/obj/item/storage/box/freezer,/turf/simulated/floor/tiled/white,/area/space)
"h" = (/obj/effect/floor_decal/corner/blue/diagonal,/obj/structure/table/glass,/obj/item/storage/box/gloves,/obj/item/storage/box/masks,/turf/simulated/floor/tiled/white,/area/space)
"i" = (/obj/effect/floor_decal/corner/blue/diagonal,/turf/simulated/floor/tiled/white,/area/space)
"j" = (/obj/structure/lattice,/turf/simulated/open,/area/space)
"k" = (/obj/machinery/light{dir = 1},/obj/effect/floor_decal/corner/blue/diagonal,/turf/simulated/floor/tiled/white,/area/space)
"l" = (/obj/effect/floor_decal/corner/blue/diagonal,/obj/structure/table/glass,/obj/item/storage/firstaid/surgery,/turf/simulated/floor/tiled/white,/area/space)
"m" = (/obj/effect/floor_decal/corner/blue/diagonal,/obj/structure/sink{icon_state = "sink"; dir = 4},/turf/simulated/floor/tiled/white,/area/space)
"n" = (/turf/simulated/open,/area/space)
"o" = (/obj/effect/floor_decal/corner/blue/diagonal,/obj/structure/table/glass,/obj/item/reagent_containers/dropper,/obj/item/reagent_containers/chem_disp_cartridge/peridaxon,/obj/item/stack/nanopaste,/obj/machinery/light{icon_state = "tube1"; dir = 8},/turf/simulated/floor/tiled/white,/area/space)
"p" = (/obj/effect/floor_decal/corner/blue/diagonal,/obj/machinery/body_scanconsole{icon_state = "body_scannerconsole"; dir = 4},/turf/simulated/floor/tiled/white,/area/space)
"q" = (/obj/effect/floor_decal/corner/blue/diagonal,/obj/machinery/bodyscanner{icon_state = "body_scanner_0"; dir = 4},/turf/simulated/floor/tiled/white,/area/space)
"r" = (/obj/effect/floor_decal/corner/blue/diagonal,/obj/machinery/sleeper{icon_state = "sleeper_0"; dir = 8},/turf/simulated/floor/tiled/white,/area/space)
"s" = (/obj/machinery/light_switch{pixel_x = 25},/obj/effect/floor_decal/corner/blue/diagonal,/turf/simulated/floor/tiled/white,/area/space)
"t" = (/obj/effect/floor_decal/corner/blue/diagonal,/obj/structure/table/glass,/obj/item/scalpel/laser1,/obj/item/scalpel/laser2,/obj/item/scalpel/laser3,/obj/item/device/robotanalyzer,/obj/item/device/healthanalyzer,/obj/item/storage/firstaid/adv,/turf/simulated/floor/tiled/white,/area/space)
"u" = (/obj/effect/floor_decal/corner/blue/diagonal,/obj/structure/ladder/updown,/turf/simulated/floor/tiled/white,/area/space)
"v" = (/obj/effect/floor_decal/corner/blue/diagonal,/obj/machinery/atmospherics/unary/freezer,/turf/simulated/floor/tiled/white,/area/space)
"w" = (/obj/effect/floor_decal/corner/blue/diagonal,/obj/machinery/atmospherics/unary/cryo_cell,/turf/simulated/floor/tiled/white,/area/space)
"x" = (/obj/effect/floor_decal/corner/blue/diagonal,/obj/machinery/portable_atmospherics/canister/oxygen/prechilled,/obj/machinery/atmospherics/portables_connector,/turf/simulated/floor/tiled/white,/area/space)
"y" = (/obj/effect/floor_decal/corner/blue/diagonal,/obj/structure/closet/secure_closet/freezer/meat,/turf/simulated/floor/tiled/white,/area/space)
"z" = (/obj/effect/floor_decal/corner/blue/diagonal,/obj/machinery/mecha_part_fabricator,/turf/simulated/floor/tiled/white,/area/space)
"A" = (/obj/effect/floor_decal/corner/blue/diagonal,/obj/machinery/atmospherics/pipe/simple/visible/blue{icon_state = "intact"; dir = 5},/turf/simulated/floor/tiled/white,/area/space)
"B" = (/obj/effect/floor_decal/corner/blue/diagonal,/obj/machinery/atmospherics/pipe/manifold/visible/blue,/obj/item/reagent_containers/glass/beaker/cryoxadone,/turf/simulated/floor/tiled/white,/area/space)
"C" = (/obj/effect/floor_decal/corner/blue/diagonal,/obj/machinery/atmospherics/pipe/simple/visible/blue{icon_state = "intact"; dir = 9},/turf/simulated/floor/tiled/white,/area/space)
"D" = (/obj/effect/floor_decal/corner/blue/diagonal,/obj/machinery/light{icon_state = "tube1"; dir = 4},/turf/simulated/floor/tiled/white,/area/space)
"E" = (/obj/effect/floor_decal/corner/blue/diagonal,/obj/machinery/organ_printer/flesh/mapped,/turf/simulated/floor/tiled/white,/area/space)
"F" = (/obj/effect/floor_decal/corner/blue/diagonal,/obj/machinery/organ_printer/robot/mapped,/turf/simulated/floor/tiled/white,/area/space)
"G" = (/obj/machinery/light_switch{pixel_x = -25},/obj/effect/floor_decal/corner/blue/diagonal,/turf/simulated/floor/tiled/white,/area/space)
"H" = (/obj/machinery/light{icon_state = "tube1"; dir = 8},/obj/effect/floor_decal/corner/blue/diagonal,/turf/simulated/floor/tiled/white,/area/space)
"I" = (/obj/machinery/light{icon_state = "tube1"; dir = 4},/obj/effect/floor_decal/corner/blue/diagonal,/turf/simulated/floor/tiled/white,/area/space)
"J" = (/obj/structure/cable{d2 = 2; icon_state = "0-2"; pixel_y = 0},/obj/machinery/power/apc{dir = 8; name = "west bump"; pixel_x = -24},/obj/effect/floor_decal/corner/blue/diagonal,/turf/simulated/floor/tiled/white,/area/space)
"K" = (/obj/structure/cable{d1 = 1; d2 = 2; icon_state = "1-2"; pixel_y = 0},/obj/effect/floor_decal/corner/blue/diagonal,/turf/simulated/floor/tiled/white,/area/space)
"L" = (/obj/structure/cable,/obj/machinery/power/debug_items/infinite_generator,/obj/effect/floor_decal/corner/blue/diagonal,/turf/simulated/floor/tiled/white,/area/space)
"M" = (/obj/machinery/light,/obj/effect/floor_decal/corner/blue/diagonal,/turf/simulated/floor/tiled/white,/area/space)

(1,1,1) = {"
aaaaaaaaaaaaaaaaaaaaaaaaaaaaaaaaaaaaaaaaaaaaaaaa
aaaaaaaaaaaaaaaaaaaaaaaaaaaaaaaaaaaaaaaaaaaaaaaa
aaaaaaaaaaaaaaaaaaaaaaaaaaaaaaaaaaaaaaaaaaaaaaaa
aaaaaaaaaaaaaaaaaaaaaaaaaaaaaaaaaaaaaaaaaaaaaaaa
aaaaaaaaaaaaaaaaaaaaaaaaaaaaaaaaaaaaaaaaaaaaaaaa
aaaaaaaaaaaaaaaaaaaaaaaaaaaaaaaaaaaaaaaaaaaaaaaa
aaaaaaaaaaaaaaaaaaaaaaaaaaaaaaaaaaaaaaaaaaaaaaaa
aaaaaaaaaaaaaaaaaaaaaaaaaaaaaaaaaaaaaaaaaaaaaaaa
aaaaaaaaaaaaaaaaaaaaaaaaaaaaaaaaaaaaaaaaaaaaaaaa
aaaaaaaaaaaaabaaacccccccccccccccaaaaaaaaaaaaaaaa
aaaaaaaaaaaaaaaaacdefghijiikiiicaaaaaaaaaaaaaaaa
aaaaaaaaaaaaaaaaacliiimjjniiiiicaaaaaaaaaaaaaaaa
aaaaaaaaaaaaaaaaacopqirnnniiiiscaaaaaaaaaaaaaaaa
aaaaaaaaaaaaaaaaactiiiuvwxiiiiicaaaaaaaaaaaaaaaa
aaaaaaaaaaaaaaaaacyiziiABCiiiiDcaaaaaaaaaaaaaaaa
aaaaaaaaaaaaaaaaacEiiiiiiiiiiiicaaaaaaaaaaaaaaaa
aaaaaaaaaaaaaaaaacFiiiiiiiiiiiicaaaaaaaaaaaaaaaa
aaaaaaaaaaaaaaaaaciiiiiiiiiiiiicaaaaaaaaaaaaaaaa
aaaaaaaaaaaaaaaaacGiiiiiiiiiiiicaaaaaaaaaaaaaaaa
aaaaaaaaaaaaaaaaacHiiiiiiiiiiiIcaaaaaaaaaaaaaaaa
aaaaaaaaaaaaaaaaacJiiiiiiiiiiiicaaaaaaaaaaaaaaaa
aaaaaaaaaaaaaaaaacKiiiiiiiiiiiicaaaaaaaaaaaaaaaa
aaaaaaaaaaaaaaaaacLiiMiiiiiMiiicaaaaaaaaaaaaaaaa
aaaaaaaaaaaaaaaaacccccccccccccccaaaaaaaaaaaaaaaa
aaaaaaaaaaaaaaaaaaaaaaaaaaaaaaaaaaaaaaaaaaaaaaaa
aaaaaaaaaaaaaaaaaaaaaaaaaaaaaaaaaaaaaaaaaaaaaaaa
aaaaaaaaaaaaaaaaaaaaaaaaaaaaaaaaaaaaaaaaaaaaaaaa
aaaaaaaaaaaaaaaaaaaaaaaaaaaaaaaaaaaaaaaaaaaaaaaa
aaaaaaaaaaaaaaaaaaaaaaaaaaaaaaaaaaaaaaaaaaaaaaaa
aaaaaaaaaaaaaaaaaaaaaaaaaaaaaaaaaaaaaaaaaaaaaaaa
aaaaaaaaaaaaaaaaaaaaaaaaaaaaaaaaaaaaaaaaaaaaaaaa
aaaaaaaaaaaaaaaaaaaaaaaaaaaaaaaaaaaaaaaaaaaaaaaa
"}
